R 1080 800
NO ./textures/no_textures.xpm
SO ./textures/so_textures.xpm
WE ./textures/we_textures.xpm
EA ./textures/ea_textures.xpm

S ./textures/omon.xpm
F 102,0,204    
C 0,0,0

        1111111111111111111111111
        1000000000110000000000001
        1000000000110020000002001
        1000000000110000000000001
        1000000000110002000000001
        1011000001110000002000001
        1001000000000000000000001
111111111011000001110020000002001
111111111011000001110000000000001
1000000000110000011101111000111111
10110111111111011100000010001
11110111111111011101010010001
10000000110101011100000010001
10000000000000001100000010001
10000000000000001101010010E01
11000001110101011111011110001
11110111 1110101 101111010001
11111111 1111111 111111111111
