R 1500 1000
NO ./textures/no_textures.xpm
SO ./textures/so_textures.xpm
WE ./textures/we_textures.xpm
EA ./textures/ea_textures.xpm
S ./textures/no_textures.xpm
F 100,100,0
C 225,30,0
        1111111111111111111111111
        1000000000110000001000001
        1011000001110000000000001
        100100000000000000W000001
111111111011000001110000000000001
100000000011000001110111111111111
11110111111111011100000010001
11110111111111011101010010001
11000000110101011100000010001
10002000000000001100000010001
10000000000000001101010010001
1100000111010101111101111000111
11110111 1110101 101111010001
11111111 1111111 111111111111
